1111111111111111111111111
1111111111111111111111111
0000000000000000000000000
0000000000000000000000000
1110077777777777777770000
1110000000000000000000000
1110000000000000000000000
1110000000000000000000550
1110000000000000000000000
0000000000000000000000000
0000000000055000000500000
1100000000000000000000000
0000055000000000000000000
0000000000000000000000000
0000000000000000000000000
0000000000000000000000000
0000000000000000000000000
0000000000000000000000000
0000000000000000000000000
0000000000000000000000000
0000000000000000000000000
