0000000000000000000000000
0000000000000000000000000
0000000000000000000000000
0000000000000000000000000
0000000000000000000000000
0000000000000000000000000
0000000000000000000000000
0000000000000000000000000
0000000000000000000000000
0000000000000000000000000
0000000000000000000000000
0000000000000000000000000
1000000000000000000000000
1000000000000000000000000
1000000000000000000000000
1000000000000000000000000
1000000000000000000000000
1000000000000000000000000
0000000000000000000000000
2222222222222222222222220
1111111111111111111111111
