0000000000000000000000000
0000000000000000000000000
0000000000000000000000000
0000000000000000000000000
0000000000000000000000000
0000000000000000000000000
0000000000000000000000000
0000000000000000000000000
0000000000000000000000000
0000000000000000000000000
0000000000000000000000000
0000000000000000000000000
0000000000000000000000000
0000000000000000000000001
0000000000000000000000001
0000000000000000000000001
0000000000000000000000011
0000000000000000000000001
0000000000000000000000001
0000000001444444441000001
1111111111444444441111111
