0000000000000000000000000
0000000000000000000000000
0000000003000000000000000
0000000000000000000000000
0000000000000000000000000
0000000000000000000000000
0000000000000300000000000
0000000000000000000000000
0000000000000000000000000
0000000000000000000000000
0000000000000000000000000
0000000000000000000000000
0000000000300000000000000
0000000000000000000000000
0000000000000000000000000
0000000000000000000000000
0000000000000000000000000
0000000000000000000000000
0000000000000000000000000
0000000000333300000000000
1111111111111111111111111
