0000000000000000000000000
0000000000000000000000000
0000000000000000000000000
0000000000000000000000000
0000000000000000000000000
0000000000000000000000000
0000000000000000000000000
0000030000000030000000000
0000000000000000000000000
0000000000333300000000000
0300000033003300000000000
0300000000003000000000000
0030000000000000003000000
0003300000000000033000000
0000333300000000330000000
0000000333300333000000000
0000000000033300000000000
0000000000000000000000000
0000000000000000000000000
0000000000000000000000000
1111111111111111111111111
