0000000000000000000000001
0000000000000000000000001
0000000000000000000000001
0000000000000000000000001
0000000000000000000000001
0000000000000000000000001
0000000000000000000000001
0000000000000000000000001
0000000000000000000000001
0000000000000000000000001
0000000000000000000000001
0000000000000000000000001
0000000000000000000000001
0000000000000000000000001
0000000000000000000000001
0000000000000000000000001
3300000000000000000000001
0000000000000000000000001
0000007770006666600000001
0000000000000000000000001
0000000000000000000000000
