0000000000000000000000000
1000000000000000000000001
1000300000000000000030001
1003030000000000000303001
1003030000333330000303001
1000000000300030000000001
1000000000000000000000001
1000000000000000000000001
1000300030000000300030001
1000300030000000300030001
1300300030000000300030031
1000300030300030300030001
1000033300303030033300001
1000000000030300000000001
1000000000000000000000001
1000000000000000000000001
1333000000000000000003331
1300300000000000000030031
1301030000000000000303031
1111111100000000011111111
0000000000000000000000000
