0000111110000000000001000
0000000000000000000001000
0000000000000000000001000
0000000000000000000000000
0000000000000000000000000
0000000000011100000000000
0000000000000011000000000
0000000000000000100000000
0000000000000000000000000
0000111100000000000000000
0000000000000000000550000
0000000000000000000000000
0000000000000000000000002
1000000000011110000000002
1000000000000000000000002
1000000000000000000000002
1000000000000000000011002
1000000000000000000011002
1000000000000000000011000
1331112221111111441111111
1111111111111111111111111
